20 15 114 1
D:\Programming\Commander Keen Files\masks_large.png
-1
-1
-1
-1
-1
-1
-1
-1
-1
-1
-1
-1
-1
-1
-1
-1
416 64 0 0 0 0 0 0 1 0
-1
-1
-1
64 0 0 0 0 0 0 0 0 0
64 0 0 0 0 0 0 0 0 0
64 0 0 0 0 0 0 0 0 0
64 0 0 0 0 0 0 0 0 0
64 0 0 0 0 0 0 0 0 0
64 0 0 0 0 0 0 0 0 0
64 0 0 0 0 0 0 0 0 0
64 0 0 0 0 0 0 0 0 0
64 0 0 0 0 0 0 0 0 0
64 0 0 0 0 0 0 0 0 0
64 0 0 0 0 0 0 0 0 0
64 0 0 0 0 0 0 0 0 0
64 0 0 0 0 0 0 0 0 0
64 0 0 0 0 0 0 0 0 0
64 0 0 0 0 0 0 0 0 0
256 0 0 0 0 0 0 0 0 0
288 0 0 0 0 0 0 0 1 0
320 0 0 0 0 0 0 0 0 0
64 0 0 0 0 0 0 0 0 0
64 0 0 0 0 0 0 0 0 0
64 32 0 0 1 0 1 0 0 0
64 32 0 0 1 0 1 0 0 0
64 32 0 0 1 0 1 0 0 0
64 32 0 0 1 0 1 0 0 0
64 32 0 0 1 0 1 0 0 0
64 32 0 0 1 0 1 0 0 0
64 32 0 0 1 0 1 0 0 0
64 32 0 0 1 0 1 0 0 0
64 32 0 0 1 0 1 0 0 0
64 32 0 0 1 0 1 0 0 0
64 32 0 0 1 0 1 0 0 0
64 32 0 0 1 0 1 0 0 0
64 32 0 0 1 0 1 0 0 0
64 32 0 0 1 0 1 0 0 0
64 32 0 0 1 0 1 0 0 0
64 32 0 0 1 0 1 0 0 0
288 32 0 0 0 0 0 0 0 1
64 32 0 0 1 0 1 0 0 0
64 32 0 0 1 0 1 0 0 0
64 32 0 0 1 0 1 0 0 0
-1
-1
-1
-1
-1
-1
-1
-1
-1
-1
-1
-1
-1
-1
-1
-1
288 64 0 0 0 0 0 0 1 0
-1
-1
-1
-1
-1
-1
-1
-1
-1
-1
-1
-1
-1
-1
-1
-1
-1
-1
-1
320 64 0 0 0 0 0 0 1 0
-1
-1
-1
-1
-1
-1
-1
-1
-1
-1
-1
-1
-1
-1
-1
-1
-1
-1
-1
320 64 0 0 0 0 0 0 1 0
-1
-1
-1
-1
-1
-1
-1
-1
-1
128 64 0 0 1 1 1 1 0 0
128 64 0 0 1 1 1 1 0 0
128 64 0 0 1 1 1 1 0 0
128 64 0 0 1 1 1 1 0 0
-1
-1
-1
-1
-1
-1
320 64 0 0 0 0 0 0 1 0
-1
-1
-1
-1
-1
-1
-1
-1
-1
-1
-1
-1
-1
-1
-1
-1
-1
-1
-1
320 64 0 0 0 0 0 0 1 0
-1
-1
-1
-1
-1
-1
-1
-1
-1
-1
-1
-1
-1
-1
-1
-1
-1
-1
-1
320 64 0 0 0 0 0 0 1 0
-1
-1
-1
-1
-1
-1
128 64 0 0 1 1 1 1 0 0
-1
-1
-1
-1
-1
-1
-1
128 64 0 0 1 1 1 1 0 0
-1
-1
-1
-1
320 64 0 0 0 0 0 0 1 0
-1
-1
-1
-1
-1
-1
-1
-1
-1
-1
-1
-1
-1
-1
-1
-1
-1
-1
-1
320 64 0 0 0 0 0 0 1 0
-1
-1
-1
-1
-1
-1
-1
-1
-1
-1
256 224 0 0 0 0 0 0 0 0
512 128 0 0 0 0 0 0 0 0
544 128 0 0 0 0 0 0 0 0
64 0 0 0 0 0 0 0 0 0
512 0 0 0 0 0 0 0 0 0
64 64 0 0 0 0 0 0 0 0
96 64 0 0 0 0 0 0 0 0
-1
-1
320 64 0 0 0 0 0 0 1 0
-1
-1
-1
-1
-1
-1
-1
-1
192 256 0 0 0 0 0 0 0 0
224 256 0 0 0 0 0 0 0 0
256 256 6 24 1 0 0 0 0 0
512 160 20 32 1 0 0 0 0 0
544 160 0 0 1 0 0 0 0 0
64 32 0 0 1 0 1 0 0 0
512 32 32 16 1 0 0 0 0 0
64 96 16 0 1 0 0 0 0 0
96 96 0 0 0 0 0 0 0 0
64 64 0 0 0 0 0 0 0 0
96 64 0 0 0 0 0 0 0 0
320 64 0 0 0 0 0 0 1 0
-1
-1
-1
64 0 0 0 0 0 0 0 0 0
64 0 0 0 0 0 0 0 0 0
64 0 0 0 0 0 0 0 0 0
64 0 0 0 0 0 0 0 0 0
64 0 0 0 0 0 0 0 0 0
320 128 4 24 1 0 0 0 0 0
224 288 24 32 1 0 0 0 0 0
256 288 0 0 0 0 0 0 0 0
128 64 0 0 1 1 1 1 0 0
128 64 0 0 1 1 1 1 0 0
128 64 0 0 1 1 1 1 0 0
128 64 0 0 1 1 1 1 0 0
64 128 0 0 0 0 0 0 0 0
96 128 32 12 1 0 0 0 0 0
64 96 16 0 1 0 0 0 0 0
224 128 0 0 0 0 0 0 0 0
384 64 0 0 0 0 0 0 1 0
64 0 0 0 0 0 0 0 0 0
64 0 0 0 0 0 0 0 0 0
64 0 0 0 0 0 0 0 0 0
64 32 0 0 1 0 1 0 0 0
64 32 0 0 1 0 1 0 0 0
64 32 0 0 1 0 1 0 0 0
64 32 0 0 1 0 1 0 0 0
288 160 0 0 1 0 1 0 0 0
320 160 0 0 0 0 0 0 0 0
128 64 0 0 1 1 1 1 0 0
192 64 0 0 0 0 0 0 0 0
128 64 0 0 1 1 1 1 0 0
128 64 0 0 1 1 1 1 0 0
128 64 0 0 1 1 1 1 0 0
128 64 0 0 1 1 1 1 0 0
128 64 0 0 1 1 1 1 0 0
128 64 0 0 1 1 1 1 0 0
192 160 0 0 0 0 0 0 0 0
64 32 0 0 1 0 1 0 0 0
64 32 0 0 1 0 1 0 0 0
64 32 0 0 1 0 1 0 0 0
64 32 0 0 1 0 1 0 0 0
64 32 0 0 1 0 1 0 0 0

